17
17
XXXXXXXXCXXXXXXXX
X...............X
X...............X
X...............X
X..........X....X
X...............X
X...............X
X...............X
X...............C
X...............X
X......M........X
X...............X
X.....XXX.......X
X...............X
X...............X
X..........M....X
XXXXXXXXCXXXXXXXX