17
17
XXXXXXXXSXXXXXXXX
X...............X
X...............X
X...............X
X..........X....X
X...............X
X...............X
X...............X
X...............S
X...............X
X......M........X
X...............X
X.....XXX.......X
X......FF.......X
X......FF.......X
X..........M....X
XXXXXXXXSXXXXXXXX