17
17
XXXXXXXXXXXXXXXXX
X...............X
X...............X
X...............X
X...............X
X...............X
X...............X
X...............X
C...............C
X...............X
X...............X
X...............X
X...............X
X...............X
X...............X
X...............X
XXXXXXXXCXXXXXXXX