17
17
XXXXXXXXSXXXXXXXX
X...............X
X...............X
X...............X
X........MM.....X
X...............X
X...............X
X...............X
S...............S
X.......FF......X
X.......FF......X
X...............X
X...............X
X...............X
X...............X
X...............X
XXXXXXXXSXXXXXXXX