17
17
XXXXXXXXCXXXXXXXX
X...............X
X...............X
X...............X
X...............X
X...............X
X...............X
X...............X
C...............C
X...............X
X...............X
X...............X
X...............X
X...............X
X...............X
X...............X
XXXXXXXXCXXXXXXXX