17
17
XXXXXXXXXXXXXXXXX
X...............X
X...............X
X...........M...X
X...............X
X...............X
X...............X
X...............X
X.......P.......S
X...............X
X...............X
X...............X
X...............X
X......FF.......X
X......FF.......X
X...............X
XXXXXXXXSXXXXXXXX