17
17
XXXXXXXXSXXXXXXXX
X...............X
X...............X
X...............X
X...............X
X...............X
X...............X
X...............X
S...............S
X...............X
X...............X
X...............X
X........FF.....X
X........FF.....X
X...............X
X...............X
XXXXXXXXXXXXXXXXX