17
17
XXXXXXXXXXXXXXXXX
X...............X
X...............X
X...........M...X
X...............X
X...............X
X...............X
X...............X
X.......P.......C
X...............X
X...............X
X...............X
X...............X
X...............X
X...............X
X...............X
XXXXXXXXCXXXXXXXX