17
17
XXXXXXXXCXXXXXXXX
X...............X
X...............X
X...............X
X...............X
X...............X
X...............X
X...............X
X...............C
X...............X
X...............X
X...............X
X...............X
X...............X
X...............X
X...............X
XXXXXXXXXXXXXXXXX