17
17
XXXXXXXXSXXXXXXXX
X...............X
X...............X
X...............X
X...............X
X....MMMM.......X
X...............X
X......FF.......X
S......FF.......X
X...............X
X...............X
X...............X
X...............X
X...............X
X...............X
X...............X
XXXXXXXXSXXXXXXXX