17
17
XXXXXXXXXXXXXXXXX
X...............X
X...............X
X...............X
X...............X
X...............X
X...............X
X...............X
S...............S
X...............X
X.......FF......X
X.......FF......X
X...............X
X...............X
X...............X
X...............X
XXXXXXXXSXXXXXXXX