17
17
XXXXXXXXSXXXXXXXX
X...............X
X...............X
X...............X
X...............X
X...............X
X...............X
X...............X
S.......FF......S
X.......FF......X
X...............X
X...............X
X...............X
X...............X
X...............X
X...............X
XXXXXXXXSXXXXXXXX