17
17
XXXXXXXXSXXXXXXXX
X...............X
X...............X
X...............X
X...............X
X...............X
X...............X
X...............X
S...............X
X...............X
X...............X
X......FF.......X
X......FF.......X
X...............X
X...............X
X...............X
XXXXXXXXSXXXXXXXX